111111111111111111
111111111111111111
111000000000001111
111000000000000011
100000000000000011
100000000000000001
100000000000000001
000000000000000001
000000000000000001
000000000000000001
000000000000000001
000000000000000001
000000000000000001
000000000000000000
000000000000000000
000000000000000000
100000000000000001
100000000000000001
111000000000000011
111000000000000111
111111111111111111
111111111111111111
end